 WWWWW    WWWWWWW 
WFFFFFW  WFFFFFFFW
WFFFFFW  WFFFFFFFW   WWW    WWWWWWWWWWWW
WFFFFFWWWWFFFFFFFW  WFFFW  WFFFFFFFFFFFFW
WFFFFFDFFDFFFFFFFW  WFFFW  WFFFFFFFFFFFFW
WFFFFFDFFDFFFFFFFW  WFFFWWWWFFFFFFFFFFFFW
 WWWWWWWWWFFFFFFFWWWWFFFDFFDFFFFFFFFFFFFW
WFFFFFW  WFFFFFFFDFFDFFFDFFDFFFFFFFFFFFFW
WFFFFFW  WFFFFFFFDFFDFFFWWWWFFFWWWWWFFFFW
WFFFFFW  WFFFFFFFWWWWFFFW  WFFFWFFFWFFFFW
WFFFFFW  WFFFFFFFW   WDW   WFFFWFFFWFFFFW
WFFFFFW   WDDWWWW   WFFFW  WFFFWFFFWFFFFW   WWWWWWWW
WFFFFFW   WFFW      WFFFW  WFFFWFFFWFFFFW  WFFFDFFFFW
WFFFFFW   WFFW   WWWWFFFW  WFFFWFFFWFFFFW  WFFFDFFFFW
WFFFFFW   WFFW  WFFFWFFFW  WFFFWFFFWFFFFW  WFFFWFFFFW
WFFFFFW   WFFW  WFFFDFFFW  WFFFWWDWWFFFFW  WFFFWFFFFWWWWWW
WFFFFFW   WFFW  WFFFDFFFW  WFFFFFFFFFFFFW  WFFFWFFFFWFFFFFW
WFFFWWWWWWWDDW  WFFFWFFFW  WFFFFFFFFFFFFW  WFFFWWWWWWFFFFFW
WFFFWFFFFFFFFFW  WWWWWWW   WFFFFFFFFFFFFW  WFFFWFFFFWFFFFFW
WFFFWFFFFFFFFFW            WFFFFFFFFFFFFW  WFFFWFFFFWFFFFFW
WFFFWFFFFFFFFFW   WWWWWWWWWWFFFFFFFFFFFFW  WFFFWFFFFDFFFFFW
WFFFDFFFFFFFFFW  WFFFFFFFFFFFFFFFFFFFFFFW  WFFFWFFFFDFFFFFG
WFFFDFFFFFFFFFW  WFFFFFFFFFFFFFFFFFFFFFFW  WFFFWFFFFWFFFFFG
WFFFWFFFFFFFFFW  WFFFFFFFFFFFFFFFFFFFFFFW  WFFFWFFFFWFFFFFW
 WWWWFFFFFFFFFW  WFFFFFFFFFFFFFFFFFFFFFFWWWWDDWWFFFFWFFFFFW
    WFFFFFFFFFW  WFFFFFFFFFFFFFFFFFFFFFFWFFFFFFWFFFFWFFFFFW
	 WWWWWWFFFW  WFFFFFFFFFFFFFFFFFFFFFFWFFFFFFWWWDWWFFFFFW
	      WFFFW  WFFFFFFFFFFFFFFFFFFFFFFWFFFFFFWFFFFWFFFFFW
		  WFFFW  WFFFFFFFFFFFFFFFFFFFFFFWFFFFFFWFFFFWWWWWW
		  WFFFW  WFFFFFFFFFFFFFFFFFFFFFFWFFFFFFWFFFFW
		  WFFFW  WFFFFFFFFFFFFFFFFFFFFFFWFFFFFFWFFFFW
      WWWWWWDDWW WFFFFFFFFFFFFFFFFFFFFFFWFFFFFFDFFFFW
	 WFFFFWFFFFFWWFFFFFFFFFFFFFFFFFFFFFFWFFFFFFDFFFFW
	 WFFFFDFFFFFWWFFFFFFFFFFFWWDWWWWWFFFDFFFFFFWFFFFW
	 WFFFFDFFFFFWWFFFFFFFFFFFWFFFWFFWFFFDFFFFFFWFFFFW
	 WFFFFWFFFFFWWFFFFFFFFFFFWFFFWFFWFFFWFFFFFFWFFFFW
	  WWWWWWWGGW WFFFFFFFFFFFDFFFDFFWFFFWFFFFFFWFFFFW
	             WFFFFFFFFFFFWFFFWFFWFFFWWWWWWWWWWWW
				 WFFFFFFFFFFFWFFFWFFWFFFW
				 GFFFFFFFFFFFWWWWWWWWFFFW
				 GFFFFFFFFFFFFFFFFFFFFFFW
				 WFFFFFFFFFFFFFFFFFFFFFFW
				 WFFFFFFFFFFFFFFFFFFFFFFW
				 WFFFFFFFFFFFFFFFFFFFFFFW
				 WFFFFFFFFFFFFFFFFFFFFFFW
				 WFFFFFFFFFFFFFFFFFFFFFFW
				 WFFFFFFFFFFFFFFFFFFFFFFW
				  WWWWWWGGWWWWWWWWWWWWWW